"country","geoid","pop","schedule","t","daily_cases","daily_deaths","cumulative_cases","cumulative_deaths"
"Brazil","BR",211049519,2020-02-26,1,1,0,1,0
"Brazil","BR",211049519,2020-02-27,2,0,0,1,0
"Brazil","BR",211049519,2020-02-28,3,0,0,1,0
"Brazil","BR",211049519,2020-02-29,4,0,0,1,0
"Brazil","BR",211049519,2020-03-01,5,1,0,2,0
"Brazil","BR",211049519,2020-03-02,6,0,0,2,0
"Brazil","BR",211049519,2020-03-03,7,0,0,2,0
"Brazil","BR",211049519,2020-03-04,8,0,0,2,0
"Brazil","BR",211049519,2020-03-05,9,1,0,3,0
"Brazil","BR",211049519,2020-03-06,10,5,0,8,0
"Brazil","BR",211049519,2020-03-07,11,5,0,13,0
"Brazil","BR",211049519,2020-03-08,12,0,0,13,0
"Brazil","BR",211049519,2020-03-09,13,12,0,25,0
"Brazil","BR",211049519,2020-03-10,14,0,0,25,0
"Brazil","BR",211049519,2020-03-11,15,9,0,34,0
"Brazil","BR",211049519,2020-03-12,16,18,0,52,0
"Brazil","BR",211049519,2020-03-13,17,25,0,77,0
"Brazil","BR",211049519,2020-03-14,18,21,0,98,0
"Brazil","BR",211049519,2020-03-15,19,23,0,121,0
"Brazil","BR",211049519,2020-03-16,20,79,0,200,0
"Brazil","BR",211049519,2020-03-17,21,34,0,234,0
"Brazil","BR",211049519,2020-03-18,22,57,1,291,1
"Brazil","BR",211049519,2020-03-19,23,137,3,428,4
"Brazil","BR",211049519,2020-03-20,24,193,2,621,6
"Brazil","BR",211049519,2020-03-21,25,283,5,904,11
"Brazil","BR",211049519,2020-03-22,26,224,7,1128,18
"Brazil","BR",211049519,2020-03-23,27,418,7,1546,25
"Brazil","BR",211049519,2020-03-24,28,345,9,1891,34
"Brazil","BR",211049519,2020-03-25,29,310,12,2201,46
"Brazil","BR",211049519,2020-03-26,30,232,11,2433,57
"Brazil","BR",211049519,2020-03-27,31,482,20,2915,77
"Brazil","BR",211049519,2020-03-28,32,502,15,3417,92
"Brazil","BR",211049519,2020-03-29,33,487,22,3904,114
"Brazil","BR",211049519,2020-03-30,34,352,22,4256,136
"Brazil","BR",211049519,2020-03-31,35,323,23,4579,159
"Brazil","BR",211049519,2020-04-01,36,1138,42,5717,201
"Brazil","BR",211049519,2020-04-02,37,1119,40,6836,241
"Brazil","BR",211049519,2020-04-03,38,1074,58,7910,299
"Brazil","BR",211049519,2020-04-04,39,1146,60,9056,359
"Brazil","BR",211049519,2020-04-05,40,1222,73,10278,432
"Brazil","BR",211049519,2020-04-06,41,852,54,11130,486
"Brazil","BR",211049519,2020-04-07,42,926,67,12056,553
"Brazil","BR",211049519,2020-04-08,43,1661,114,13717,667
"Brazil","BR",211049519,2020-04-09,44,2210,133,15927,800
"Brazil","BR",211049519,2020-04-10,45,1930,141,17857,941
"Brazil","BR",211049519,2020-04-11,46,1781,115,19638,1056
"Brazil","BR",211049519,2020-04-12,47,1089,68,20727,1124
"Brazil","BR",211049519,2020-04-13,48,1442,99,22169,1223
"Brazil","BR",211049519,2020-04-14,49,1261,105,23430,1328
"Brazil","BR",211049519,2020-04-15,50,1832,204,25262,1532
"Brazil","BR",211049519,2020-04-16,51,3058,204,28320,1736
"Brazil","BR",211049519,2020-04-17,52,2105,188,30425,1924
"Brazil","BR",211049519,2020-04-18,53,3257,217,33682,2141
"Brazil","BR",211049519,2020-04-19,54,2917,206,36599,2347
"Brazil","BR",211049519,2020-04-20,55,2055,115,38654,2462
"Brazil","BR",211049519,2020-04-21,56,1927,113,40581,2575
"Brazil","BR",211049519,2020-04-22,57,2498,166,43079,2741
"Brazil","BR",211049519,2020-04-23,58,2678,165,45757,2906
"Brazil","BR",211049519,2020-04-24,59,3735,407,49492,3313
"Brazil","BR",211049519,2020-04-25,60,3503,357,52995,3670
"Brazil","BR",211049519,2020-04-26,61,5514,346,58509,4016
"Brazil","BR",211049519,2020-04-27,62,3379,189,61888,4205
"Brazil","BR",211049519,2020-04-28,63,4613,338,66501,4543
"Brazil","BR",211049519,2020-04-29,64,5385,474,71886,5017
"Brazil","BR",211049519,2020-04-30,65,6276,449,78162,5466
"Brazil","BR",211049519,2020-05-01,66,7218,435,85380,5901
"Brazil","BR",211049519,2020-05-02,67,6209,428,91589,6329
"Brazil","BR",211049519,2020-05-03,68,4970,421,96559,6750
"Brazil","BR",211049519,2020-05-04,69,4588,275,101147,7025
"Brazil","BR",211049519,2020-05-05,70,6633,296,107780,7321
"Brazil","BR",211049519,2020-05-06,71,6935,600,114715,7921
"Brazil","BR",211049519,2020-05-07,72,10503,615,125218,8536
"Brazil","BR",211049519,2020-05-08,73,9888,610,135106,9146
"Brazil","BR",211049519,2020-05-09,74,10222,751,145328,9897
"Brazil","BR",211049519,2020-05-10,75,10611,730,155939,10627
"Brazil","BR",211049519,2020-05-11,76,6760,496,162699,11123
"Brazil","BR",211049519,2020-05-12,77,5632,396,168331,11519
"Brazil","BR",211049519,2020-05-13,78,9258,881,177589,12400
"Brazil","BR",211049519,2020-05-14,79,11385,749,188974,13149
"Brazil","BR",211049519,2020-05-15,80,13944,844,202918,13993
"Brazil","BR",211049519,2020-05-16,81,15305,824,218223,14817
"Brazil","BR",211049519,2020-05-17,82,14919,816,233142,15633
"Brazil","BR",211049519,2020-05-18,83,7938,485,241080,16118
"Brazil","BR",211049519,2020-05-19,84,13140,674,254220,16792
"Brazil","BR",211049519,2020-05-20,85,17408,1179,271628,17971
"Brazil","BR",211049519,2020-05-21,86,19951,888,291579,18859
"Brazil","BR",211049519,2020-05-22,87,18508,1188,310087,20047
"Brazil","BR",211049519,2020-05-23,88,20803,1001,330890,21048
"Brazil","BR",211049519,2020-05-24,89,16508,965,347398,22013
"Brazil","BR",211049519,2020-05-25,90,15813,653,363211,22666
"Brazil","BR",211049519,2020-05-26,91,11687,807,374898,23473
"Brazil","BR",211049519,2020-05-27,92,16324,1039,391222,24512
"Brazil","BR",211049519,2020-05-28,93,20599,1086,411821,25598
"Brazil","BR",211049519,2020-05-29,94,26417,1156,438238,26754
"Brazil","BR",211049519,2020-05-30,95,26928,1124,465166,27878
"Brazil","BR",211049519,2020-05-31,96,33274,956,498440,28834
"Brazil","BR",211049519,2020-06-01,97,16409,480,514849,29314
"Brazil","BR",211049519,2020-06-02,98,11598,623,526447,29937
"Brazil","BR",211049519,2020-06-03,99,28936,1262,555383,31199
"Brazil","BR",211049519,2020-06-04,100,28633,1349,584016,32548
"Brazil","BR",211049519,2020-06-05,101,30916,1473,614932,34021
"Brazil","BR",211049519,2020-06-06,102,30830,1005,645762,35026
"Brazil","BR",211049519,2020-06-07,103,27075,904,672837,35930
"Brazil","BR",211049519,2020-06-08,104,18921,525,691758,36455
"Brazil","BR",211049519,2020-06-09,105,15654,679,707412,37134
"Brazil","BR",211049519,2020-06-10,106,32091,1272,739503,38406
"Brazil","BR",211049519,2020-06-11,107,32913,1274,772416,39680
"Brazil","BR",211049519,2020-06-12,108,30412,1239,802828,40919
"Brazil","BR",211049519,2020-06-13,109,25982,909,828810,41828
"Brazil","BR",211049519,2020-06-14,110,21704,892,850514,42720
"Brazil","BR",211049519,2020-06-15,111,17110,612,867624,43332
"Brazil","BR",211049519,2020-06-16,112,20647,627,888271,43959
"Brazil","BR",211049519,2020-06-17,113,34918,1282,923189,45241
"Brazil","BR",211049519,2020-06-18,114,32188,1269,955377,46510
"Brazil","BR",211049519,2020-06-19,115,22765,1238,978142,47748
"Brazil","BR",211049519,2020-06-20,116,54771,1206,1032913,48954
"Brazil","BR",211049519,2020-06-21,117,34666,1022,1067579,49976
"Brazil","BR",211049519,2020-06-22,118,17459,641,1085038,50617
"Brazil","BR",211049519,2020-06-23,119,21432,654,1106470,51271
"Brazil","BR",211049519,2020-06-24,120,39436,1374,1145906,52645
"Brazil","BR",211049519,2020-06-25,121,42725,1185,1188631,53830
"Brazil","BR",211049519,2020-06-26,122,39483,1141,1228114,54971
"Brazil","BR",211049519,2020-06-27,123,46860,990,1274974,55961
"Brazil","BR",211049519,2020-06-28,124,38693,1109,1313667,57070
"Brazil","BR",211049519,2020-06-29,125,30476,552,1344143,57622
"Brazil","BR",211049519,2020-06-30,126,24052,692,1368195,58314
"Brazil","BR",211049519,2020-07-01,127,33846,1280,1402041,59594
"Brazil","BR",211049519,2020-07-02,128,46712,1038,1448753,60632
"Brazil","BR",211049519,2020-07-03,129,48105,1252,1496858,61884
"Brazil","BR",211049519,2020-07-04,130,42223,1290,1539081,63174
"Brazil","BR",211049519,2020-07-05,131,37923,1091,1577004,64265
"Brazil","BR",211049519,2020-07-06,132,26051,602,1603055,64867
"Brazil","BR",211049519,2020-07-07,133,20229,620,1623284,65487
"Brazil","BR",211049519,2020-07-08,134,45305,1254,1668589,66741
"Brazil","BR",211049519,2020-07-09,135,44571,1223,1713160,67964
"Brazil","BR",211049519,2020-07-10,136,42619,1220,1755779,69184
"Brazil","BR",211049519,2020-07-11,137,45048,1214,1800827,70398
"Brazil","BR",211049519,2020-07-12,138,39023,1071,1839850,71469
"Brazil","BR",211049519,2020-07-13,139,24831,631,1864681,72100
"Brazil","BR",211049519,2020-07-14,140,20286,733,1884967,72833
"Brazil","BR",211049519,2020-07-15,141,41857,1300,1926824,74133
"Brazil","BR",211049519,2020-07-16,142,39924,1233,1966748,75366
"Brazil","BR",211049519,2020-07-17,143,45403,1322,2012151,76688
"Brazil","BR",211049519,2020-07-18,144,34177,1163,2046328,77851
"Brazil","BR",211049519,2020-07-19,145,28532,921,2074860,78772
"Brazil","BR",211049519,2020-07-20,146,23529,716,2098389,79488
"Brazil","BR",211049519,2020-07-21,147,20257,632,2118646,80120
"Brazil","BR",211049519,2020-07-22,148,41008,1367,2159654,81487
"Brazil","BR",211049519,2020-07-23,149,67860,1284,2227514,82771
"Brazil","BR",211049519,2020-07-24,150,59961,1311,2287475,84082
"Brazil","BR",211049519,2020-07-25,151,55891,1156,2343366,85238
"Brazil","BR",211049519,2020-07-26,152,51147,1211,2394513,86449
"Brazil","BR",211049519,2020-07-27,153,24578,555,2419091,87004
"Brazil","BR",211049519,2020-07-28,154,23284,614,2442375,87618
"Brazil","BR",211049519,2020-07-29,155,40816,921,2483191,88539
"Brazil","BR",211049519,2020-07-30,156,69074,1595,2552265,90134
"Brazil","BR",211049519,2020-07-31,157,57837,1129,2610102,91263
"Brazil","BR",211049519,2020-08-01,158,52383,1212,2662485,92475
"Brazil","BR",211049519,2020-08-02,159,45392,1088,2707877,93563
"Brazil","BR",211049519,2020-08-03,160,25800,541,2733677,94104
"Brazil","BR",211049519,2020-08-04,161,16641,561,2750318,94665
"Brazil","BR",211049519,2020-08-05,162,51603,1154,2801921,95819
"Brazil","BR",211049519,2020-08-06,163,57152,1437,2859073,97256
"Brazil","BR",211049519,2020-08-07,164,53139,1237,2912212,98493
"Brazil","BR",211049519,2020-08-08,165,50230,1079,2962442,99572
"Brazil","BR",211049519,2020-08-09,166,49970,905,3012412,100477
"Brazil","BR",211049519,2020-08-10,167,23010,572,3035422,101049
"Brazil","BR",211049519,2020-08-11,168,22048,703,3057470,101752
"Brazil","BR",211049519,2020-08-12,169,52160,1274,3109630,103026
"Brazil","BR",211049519,2020-08-13,170,55155,1175,3164785,104201
"Brazil","BR",211049519,2020-08-14,171,60091,1262,3224876,105463
"Brazil","BR",211049519,2020-08-15,172,50644,1060,3275520,106523
"Brazil","BR",211049519,2020-08-16,173,41576,709,3317096,107232
"Brazil","BR",211049519,2020-08-17,174,23101,620,3340197,107852
"Brazil","BR",211049519,2020-08-18,175,19373,684,3359570,108536
"Brazil","BR",211049519,2020-08-19,176,47784,1352,3407354,109888
"Brazil","BR",211049519,2020-08-20,177,49298,1212,3456652,111100
"Brazil","BR",211049519,2020-08-21,178,45323,1204,3501975,112304
"Brazil","BR",211049519,2020-08-22,179,30355,1054,3532330,113358
"Brazil","BR",211049519,2020-08-23,180,50032,892,3582362,114250
"Brazil","BR",211049519,2020-08-24,181,23421,494,3605783,114744
"Brazil","BR",211049519,2020-08-25,182,17078,565,3622861,115309
"Brazil","BR",211049519,2020-08-26,183,47134,1271,3669995,116580
"Brazil","BR",211049519,2020-08-27,184,47161,1085,3717156,117665
"Brazil","BR",211049519,2020-08-28,185,44235,984,3761391,118649
"Brazil","BR",211049519,2020-08-29,186,43412,855,3804803,119504
"Brazil","BR",211049519,2020-08-30,187,41350,958,3846153,120462
"Brazil","BR",211049519,2020-08-31,188,16158,366,3862311,120828
"Brazil","BR",211049519,2020-09-01,189,45961,553,3908272,121381
"Brazil","BR",211049519,2020-09-02,190,42659,1215,3950931,122596
"Brazil","BR",211049519,2020-09-03,191,46934,1184,3997865,123780
"Brazil","BR",211049519,2020-09-04,192,43773,834,4041638,124614
"Brazil","BR",211049519,2020-09-05,193,51194,907,4092832,125521
"Brazil","BR",211049519,2020-09-06,194,30168,682,4123000,126203
"Brazil","BR",211049519,2020-09-07,195,14521,447,4137521,126650
"Brazil","BR",211049519,2020-09-08,196,10273,310,4147794,126960
"Brazil","BR",211049519,2020-09-09,197,14279,504,4162073,127464
"Brazil","BR",211049519,2020-09-10,198,35816,1075,4197889,128539
"Brazil","BR",211049519,2020-09-11,199,40557,983,4238446,129522
"Brazil","BR",211049519,2020-09-12,200,43718,874,4282164,130396
"Brazil","BR",211049519,2020-09-13,201,33523,814,4315687,131210
"Brazil","BR",211049519,2020-09-14,202,14768,415,4330455,131625
"Brazil","BR",211049519,2020-09-15,203,15155,381,4345610,132006
"Brazil","BR",211049519,2020-09-16,204,36653,1113,4382263,133119
"Brazil","BR",211049519,2020-09-17,205,36820,987,4419083,134106
"Brazil","BR",211049519,2020-09-18,206,36303,829,4455386,134935
"Brazil","BR",211049519,2020-09-19,207,39797,858,4495183,135793
"Brazil","BR",211049519,2020-09-20,208,33057,739,4528240,136532
"Brazil","BR",211049519,2020-09-21,209,16389,363,4544629,136895
"Brazil","BR",211049519,2020-09-22,210,13439,377,4558068,137272
"Brazil","BR",211049519,2020-09-23,211,33536,836,4591604,138108
"Brazil","BR",211049519,2020-09-24,212,33281,869,4624885,138977
"Brazil","BR",211049519,2020-09-25,213,32817,831,4657702,139808
"Brazil","BR",211049519,2020-09-26,214,31911,729,4689613,140537
"Brazil","BR",211049519,2020-09-27,215,28378,869,4717991,141406
"Brazil","BR",211049519,2020-09-28,216,14318,335,4732309,141741
"Brazil","BR",211049519,2020-09-29,217,13155,317,4745464,142058
"Brazil","BR",211049519,2020-09-30,218,32058,863,4777522,142921
"Brazil","BR",211049519,2020-10-01,219,33413,1031,4810935,143952
"Brazil","BR",211049519,2020-10-02,220,36157,728,4847092,144680
"Brazil","BR",211049519,2020-10-03,221,33431,708,4880523,145388
"Brazil","BR",211049519,2020-10-04,222,26310,599,4906833,145987
"Brazil","BR",211049519,2020-10-05,223,8456,365,4915289,146352
"Brazil","BR",211049519,2020-10-06,224,11946,323,4927235,146675
"Brazil","BR",211049519,2020-10-07,225,41906,819,4969141,147494
"Brazil","BR",211049519,2020-10-08,226,31553,734,5000694,148228
"Brazil","BR",211049519,2020-10-09,227,27750,729,5028444,148957
"Brazil","BR",211049519,2020-10-10,228,27444,682,5055888,149639
"Brazil","BR",211049519,2020-10-11,229,26749,559,5082637,150198
"Brazil","BR",211049519,2020-10-12,230,12345,290,5094982,150488
"Brazil","BR",211049519,2020-10-13,231,8426,201,5103408,150689
"Brazil","BR",211049519,2020-10-14,232,10220,309,5113628,150998
"Brazil","BR",211049519,2020-10-15,233,27235,749,5140863,151747
"Brazil","BR",211049519,2020-10-16,234,28523,713,5169386,152460
"Brazil","BR",211049519,2020-10-17,235,30914,754,5200300,153214
"Brazil","BR",211049519,2020-10-18,236,24062,461,5224362,153675
"Brazil","BR",211049519,2020-10-19,237,10982,230,5235344,153905
"Brazil","BR",211049519,2020-10-20,238,15383,271,5250727,154176
"Brazil","BR",211049519,2020-10-21,239,23227,661,5273954,154837
"Brazil","BR",211049519,2020-10-22,240,24818,566,5298772,155403
"Brazil","BR",211049519,2020-10-23,241,24858,497,5323630,155900
"Brazil","BR",211049519,2020-10-24,242,30026,571,5353656,156471
"Brazil","BR",211049519,2020-10-25,243,26979,432,5380635,156903
"Brazil","BR",211049519,2020-10-26,244,13493,231,5394128,157134
"Brazil","BR",211049519,2020-10-27,245,15726,263,5409854,157397
"Brazil","BR",211049519,2020-10-28,246,29787,549,5439641,157946
"Brazil","BR",211049519,2020-10-29,247,28629,510,5468270,158456
"Brazil","BR",211049519,2020-10-30,248,26106,513,5494376,158969
"Brazil","BR",211049519,2020-10-31,249,22282,508,5516658,159477
"Brazil","BR",211049519,2020-11-01,250,18947,407,5535605,159884
"Brazil","BR",211049519,2020-11-02,251,10100,190,5545705,160074
"Brazil","BR",211049519,2020-11-03,252,8501,179,5554206,160253
"Brazil","BR",211049519,2020-11-04,253,11843,243,5566049,160496
"Brazil","BR",211049519,2020-11-05,254,23976,610,5590025,161106
"Brazil","BR",211049519,2020-11-06,255,22294,630,5612319,161736
"Brazil","BR",211049519,2020-11-07,256,21428,302,5633747,162038
"Brazil","BR",211049519,2020-11-08,257,19814,231,5653561,162269
"Brazil","BR",211049519,2020-11-09,258,10554,128,5664115,162397
"Brazil","BR",211049519,2020-11-10,259,10917,231,5675032,162628
"Brazil","BR",211049519,2020-11-11,260,25012,201,5700044,162829
"Brazil","BR",211049519,2020-11-12,261,48331,544,5748375,163373
"Brazil","BR",211049519,2020-11-13,262,33207,908,5781582,164281
"Brazil","BR",211049519,2020-11-14,263,29070,456,5810652,164737
"Brazil","BR",211049519,2020-11-15,264,38307,921,5848959,165658
"Brazil","BR",211049519,2020-11-16,265,14134,140,5863093,165798
"Brazil","BR",211049519,2020-11-17,266,13371,216,5876464,166014
"Brazil","BR",211049519,2020-11-18,267,35294,685,5911758,166699
"Brazil","BR",211049519,2020-11-19,268,34091,756,5945849,167455
"Brazil","BR",211049519,2020-11-20,269,35918,606,5981767,168061
"Brazil","BR",211049519,2020-11-21,270,38397,552,6020164,168613
"Brazil","BR",211049519,2020-11-22,271,32622,376,6052786,168989
"Brazil","BR",211049519,2020-11-23,272,18615,194,6071401,169183
"Brazil","BR",211049519,2020-11-24,273,16207,302,6087608,169485
"Brazil","BR",211049519,2020-11-25,274,31100,630,6118708,170115
"Brazil","BR",211049519,2020-11-26,275,47898,654,6166606,170769
"Brazil","BR",211049519,2020-11-27,276,37614,691,6204220,171460
"Brazil","BR",211049519,2020-11-28,277,34130,514,6238350,171974
"Brazil","BR",211049519,2020-11-29,278,51922,587,6290272,172561
"Brazil","BR",211049519,2020-11-30,279,24468,272,6314740,172833
"Brazil","BR",211049519,2020-12-01,280,21138,287,6335878,173120
"Brazil","BR",211049519,2020-12-02,281,50909,697,6386787,173817
"Brazil","BR",211049519,2020-12-03,282,49863,698,6436650,174515
"Brazil","BR",211049519,2020-12-04,283,50434,755,6487084,175270
"Brazil","BR",211049519,2020-12-05,284,46884,694,6533968,175964
"Brazil","BR",211049519,2020-12-06,285,43209,664,6577177,176628
"Brazil","BR",211049519,2020-12-07,286,26363,313,6603540,176941
"Brazil","BR",211049519,2020-12-08,287,20371,376,6623911,177317
"Brazil","BR",211049519,2020-12-09,288,51088,842,6674999,178159
"Brazil","BR",211049519,2020-12-10,289,53453,836,6728452,178995
"Brazil","BR",211049519,2020-12-11,290,53347,770,6781799,179765
"Brazil","BR",211049519,2020-12-12,291,54428,672,6836227,180437
"Brazil","BR",211049519,2020-12-13,292,43900,686,6880127,181123
"Brazil","BR",211049519,2020-12-14,293,21825,279,6901952,181402
"India","IN",1366417756,2020-01-30,1,1,0,1,0
"India","IN",1366417756,2020-01-31,2,0,0,1,0
"India","IN",1366417756,2020-02-01,3,0,0,1,0
"India","IN",1366417756,2020-02-02,4,1,0,2,0
"India","IN",1366417756,2020-02-03,5,0,0,2,0
"India","IN",1366417756,2020-02-04,6,1,0,3,0
"India","IN",1366417756,2020-02-05,7,0,0,3,0
"India","IN",1366417756,2020-02-06,8,0,0,3,0
"India","IN",1366417756,2020-02-07,9,0,0,3,0
"India","IN",1366417756,2020-02-08,10,0,0,3,0
"India","IN",1366417756,2020-02-09,11,0,0,3,0
"India","IN",1366417756,2020-02-10,12,0,0,3,0
"India","IN",1366417756,2020-02-11,13,0,0,3,0
"India","IN",1366417756,2020-02-12,14,0,0,3,0
"India","IN",1366417756,2020-02-13,15,0,0,3,0
"India","IN",1366417756,2020-02-14,16,0,0,3,0
"India","IN",1366417756,2020-02-15,17,0,0,3,0
"India","IN",1366417756,2020-02-16,18,0,0,3,0
"India","IN",1366417756,2020-02-17,19,0,0,3,0
"India","IN",1366417756,2020-02-18,20,0,0,3,0
"India","IN",1366417756,2020-02-19,21,0,0,3,0
"India","IN",1366417756,2020-02-20,22,0,0,3,0
"India","IN",1366417756,2020-02-21,23,0,0,3,0
"India","IN",1366417756,2020-02-22,24,0,0,3,0
"India","IN",1366417756,2020-02-23,25,0,0,3,0
"India","IN",1366417756,2020-02-24,26,0,0,3,0
"India","IN",1366417756,2020-02-25,27,0,0,3,0
"India","IN",1366417756,2020-02-26,28,0,0,3,0
"India","IN",1366417756,2020-02-27,29,0,0,3,0
"India","IN",1366417756,2020-02-28,30,0,0,3,0
"India","IN",1366417756,2020-02-29,31,0,0,3,0
"India","IN",1366417756,2020-03-01,32,0,0,3,0
"India","IN",1366417756,2020-03-02,33,0,0,3,0
"India","IN",1366417756,2020-03-03,34,2,0,5,0
"India","IN",1366417756,2020-03-04,35,1,0,6,0
"India","IN",1366417756,2020-03-05,36,22,0,28,0
"India","IN",1366417756,2020-03-06,37,1,0,29,0
"India","IN",1366417756,2020-03-07,38,2,0,31,0
"India","IN",1366417756,2020-03-08,39,3,0,34,0
"India","IN",1366417756,2020-03-10,40,10,0,44,0
"India","IN",1366417756,2020-03-11,41,6,0,50,0
"India","IN",1366417756,2020-03-12,42,23,0,73,0
"India","IN",1366417756,2020-03-13,43,2,1,75,1
"India","IN",1366417756,2020-03-14,44,8,1,83,2
"India","IN",1366417756,2020-03-15,45,7,0,90,2
"India","IN",1366417756,2020-03-16,46,3,0,93,2
"India","IN",1366417756,2020-03-17,47,32,1,125,3
"India","IN",1366417756,2020-03-18,48,12,0,137,3
"India","IN",1366417756,2020-03-19,49,28,0,165,3
"India","IN",1366417756,2020-03-20,50,26,1,191,4
"India","IN",1366417756,2020-03-21,51,40,0,231,4
"India","IN",1366417756,2020-03-22,52,89,0,320,4
"India","IN",1366417756,2020-03-23,53,119,3,439,7
"India","IN",1366417756,2020-03-24,54,53,2,492,9
"India","IN",1366417756,2020-03-25,55,70,0,562,9
"India","IN",1366417756,2020-03-26,56,87,4,649,13
"India","IN",1366417756,2020-03-27,57,75,4,724,17
"India","IN",1366417756,2020-03-28,58,149,2,873,19
"India","IN",1366417756,2020-03-29,59,106,6,979,25
"India","IN",1366417756,2020-03-30,60,92,4,1071,29
"India","IN",1366417756,2020-03-31,61,180,3,1251,32
"India","IN",1366417756,2020-04-01,62,146,3,1397,35
"India","IN",1366417756,2020-04-02,63,568,15,1965,50
"India","IN",1366417756,2020-04-03,64,336,6,2301,56
"India","IN",1366417756,2020-04-04,65,601,12,2902,68
"India","IN",1366417756,2020-04-05,66,472,9,3374,77
"India","IN",1366417756,2020-04-06,67,693,32,4067,109
"India","IN",1366417756,2020-04-07,68,354,5,4421,114
"India","IN",1366417756,2020-04-08,69,773,35,5194,149
"India","IN",1366417756,2020-04-09,70,540,17,5734,166
"India","IN",1366417756,2020-04-10,71,678,33,6412,199
"India","IN",1366417756,2020-04-11,72,1035,40,7447,239
"India","IN",1366417756,2020-04-12,73,909,34,8356,273
"India","IN",1366417756,2020-04-13,74,796,35,9152,308
"India","IN",1366417756,2020-04-14,75,1211,31,10363,339
"India","IN",1366417756,2020-04-15,76,1075,38,11438,377
"India","IN",1366417756,2020-04-16,77,942,37,12380,414
"India","IN",1366417756,2020-04-17,78,1007,23,13387,437
"India","IN",1366417756,2020-04-18,79,991,43,14378,480
"India","IN",1366417756,2020-04-19,80,1334,27,15712,507
"India","IN",1366417756,2020-04-20,81,1553,36,17265,543
"India","IN",1366417756,2020-04-21,82,1335,47,18600,590
"India","IN",1366417756,2020-04-22,83,1384,50,19984,640
"India","IN",1366417756,2020-04-23,84,1409,41,21393,681
"India","IN",1366417756,2020-04-24,85,1684,37,23077,718
"India","IN",1366417756,2020-04-25,86,1429,57,24506,775
"India","IN",1366417756,2020-04-26,87,1990,49,26496,824
"India","IN",1366417756,2020-04-27,88,1396,48,27892,872
"India","IN",1366417756,2020-04-28,89,1543,62,29435,934
"India","IN",1366417756,2020-04-29,90,1897,73,31332,1007
"India","IN",1366417756,2020-04-30,91,1718,67,33050,1074
"India","IN",1366417756,2020-05-01,92,1993,73,35043,1147
"India","IN",1366417756,2020-05-02,93,2293,71,37336,1218
"India","IN",1366417756,2020-05-03,94,2644,83,39980,1301
"India","IN",1366417756,2020-05-04,95,2553,72,42533,1373
"India","IN",1366417756,2020-05-05,96,3900,195,46433,1568
"India","IN",1366417756,2020-05-06,97,2958,126,49391,1694
"India","IN",1366417756,2020-05-07,98,3561,89,52952,1783
"India","IN",1366417756,2020-05-08,99,3390,103,56342,1886
"India","IN",1366417756,2020-05-09,100,3320,95,59662,1981
"India","IN",1366417756,2020-05-10,101,3277,128,62939,2109
"India","IN",1366417756,2020-05-11,102,4213,97,67152,2206
"India","IN",1366417756,2020-05-12,103,3604,87,70756,2293
"India","IN",1366417756,2020-05-13,104,3525,122,74281,2415
"India","IN",1366417756,2020-05-14,105,3722,134,78003,2549
"India","IN",1366417756,2020-05-15,106,3967,100,81970,2649
"India","IN",1366417756,2020-05-16,107,3970,103,85940,2752
"India","IN",1366417756,2020-05-17,108,4987,120,90927,2872
"India","IN",1366417756,2020-05-18,109,5242,157,96169,3029
"India","IN",1366417756,2020-05-19,110,4970,134,101139,3163
"India","IN",1366417756,2020-05-20,111,5611,140,106750,3303
"India","IN",1366417756,2020-05-21,112,5609,132,112359,3435
"India","IN",1366417756,2020-05-22,113,6088,148,118447,3583
"India","IN",1366417756,2020-05-23,114,6654,137,125101,3720
"India","IN",1366417756,2020-05-24,115,6767,147,131868,3867
"India","IN",1366417756,2020-05-25,116,6977,154,138845,4021
"India","IN",1366417756,2020-05-26,117,6535,146,145380,4167
"India","IN",1366417756,2020-05-27,118,6387,170,151767,4337
"India","IN",1366417756,2020-05-28,119,6566,194,158333,4531
"India","IN",1366417756,2020-05-29,120,7466,175,165799,4706
"India","IN",1366417756,2020-05-30,121,7964,265,173763,4971
"India","IN",1366417756,2020-05-31,122,8380,193,182143,5164
"India","IN",1366417756,2020-06-01,123,8392,230,190535,5394
"India","IN",1366417756,2020-06-02,124,8171,204,198706,5598
"India","IN",1366417756,2020-06-03,125,8909,217,207615,5815
"India","IN",1366417756,2020-06-04,126,9304,260,216919,6075
"India","IN",1366417756,2020-06-05,127,9851,273,226770,6348
"India","IN",1366417756,2020-06-06,128,9887,294,236657,6642
"India","IN",1366417756,2020-06-07,129,9971,287,246628,6929
"India","IN",1366417756,2020-06-08,130,9983,206,256611,7135
"India","IN",1366417756,2020-06-09,131,9987,331,266598,7466
"India","IN",1366417756,2020-06-10,132,9985,279,276583,7745
"India","IN",1366417756,2020-06-11,133,9996,357,286579,8102
"India","IN",1366417756,2020-06-12,134,10956,396,297535,8498
"India","IN",1366417756,2020-06-13,135,11458,386,308993,8884
"India","IN",1366417756,2020-06-14,136,11929,311,320922,9195
"India","IN",1366417756,2020-06-15,137,11502,325,332424,9520
"India","IN",1366417756,2020-06-16,138,10667,380,343091,9900
"India","IN",1366417756,2020-06-17,139,10974,2003,354065,11903
"India","IN",1366417756,2020-06-18,140,12881,334,366946,12237
"India","IN",1366417756,2020-06-19,141,13586,336,380532,12573
"India","IN",1366417756,2020-06-20,142,14516,375,395048,12948
"India","IN",1366417756,2020-06-21,143,15413,306,410461,13254
"India","IN",1366417756,2020-06-22,144,14821,445,425282,13699
"India","IN",1366417756,2020-06-23,145,14933,312,440215,14011
"India","IN",1366417756,2020-06-24,146,15968,465,456183,14476
"India","IN",1366417756,2020-06-25,147,16922,418,473105,14894
"India","IN",1366417756,2020-06-26,148,17296,407,490401,15301
"India","IN",1366417756,2020-06-27,149,18552,384,508953,15685
"India","IN",1366417756,2020-06-28,150,19906,410,528859,16095
"India","IN",1366417756,2020-06-29,151,19459,380,548318,16475
"India","IN",1366417756,2020-06-30,152,18522,418,566840,16893
"India","IN",1366417756,2020-07-01,153,18653,507,585493,17400
"India","IN",1366417756,2020-07-02,154,19148,434,604641,17834
"India","IN",1366417756,2020-07-03,155,20903,379,625544,18213
"India","IN",1366417756,2020-07-04,156,22771,442,648315,18655
"India","IN",1366417756,2020-07-05,157,24850,613,673165,19268
"India","IN",1366417756,2020-07-06,158,24248,425,697413,19693
"India","IN",1366417756,2020-07-07,159,22252,467,719665,20160
"India","IN",1366417756,2020-07-08,160,22752,482,742417,20642
"India","IN",1366417756,2020-07-09,161,24879,487,767296,21129
"India","IN",1366417756,2020-07-10,162,26506,475,793802,21604
"India","IN",1366417756,2020-07-11,163,27114,519,820916,22123
"India","IN",1366417756,2020-07-12,164,28637,551,849553,22674
"India","IN",1366417756,2020-07-13,165,28701,500,878254,23174
"India","IN",1366417756,2020-07-14,166,28498,553,906752,23727
"India","IN",1366417756,2020-07-15,167,29429,582,936181,24309
"India","IN",1366417756,2020-07-16,168,32695,606,968876,24915
"India","IN",1366417756,2020-07-17,169,34956,687,1003832,25602
"India","IN",1366417756,2020-07-18,170,34884,671,1038716,26273
"India","IN",1366417756,2020-07-19,171,38902,543,1077618,26816
"India","IN",1366417756,2020-07-20,172,40425,681,1118043,27497
"India","IN",1366417756,2020-07-21,173,37148,587,1155191,28084
"India","IN",1366417756,2020-07-22,174,37724,648,1192915,28732
"India","IN",1366417756,2020-07-23,175,45720,1129,1238635,29861
"India","IN",1366417756,2020-07-24,176,49310,740,1287945,30601
"India","IN",1366417756,2020-07-25,177,48916,757,1336861,31358
"India","IN",1366417756,2020-07-26,178,48661,705,1385522,32063
"India","IN",1366417756,2020-07-27,179,49931,708,1435453,32771
"India","IN",1366417756,2020-07-28,180,47703,654,1483156,33425
"India","IN",1366417756,2020-07-29,181,48513,768,1531669,34193
"India","IN",1366417756,2020-07-30,182,52123,775,1583792,34968
"India","IN",1366417756,2020-07-31,183,55078,779,1638870,35747
"India","IN",1366417756,2020-08-01,184,57118,764,1695988,36511
"India","IN",1366417756,2020-08-02,185,54735,853,1750723,37364
"India","IN",1366417756,2020-08-03,186,52972,771,1803695,38135
"India","IN",1366417756,2020-08-04,187,52050,803,1855745,38938
"India","IN",1366417756,2020-08-05,188,52509,857,1908254,39795
"India","IN",1366417756,2020-08-06,189,56282,904,1964536,40699
"India","IN",1366417756,2020-08-07,190,62538,886,2027074,41585
"India","IN",1366417756,2020-08-08,191,61537,933,2088611,42518
"India","IN",1366417756,2020-08-09,192,64399,861,2153010,43379
"India","IN",1366417756,2020-08-10,193,62064,1007,2215074,44386
"India","IN",1366417756,2020-08-11,194,53601,871,2268675,45257
"India","IN",1366417756,2020-08-12,195,60963,834,2329638,46091
"India","IN",1366417756,2020-08-13,196,66999,942,2396637,47033
"India","IN",1366417756,2020-08-14,197,64553,1007,2461190,48040
"India","IN",1366417756,2020-08-15,198,65002,996,2526192,49036
"India","IN",1366417756,2020-08-16,199,63490,944,2589682,49980
"India","IN",1366417756,2020-08-17,200,57981,941,2647663,50921
"India","IN",1366417756,2020-08-18,201,55079,876,2702742,51797
"India","IN",1366417756,2020-08-19,202,64531,1092,2767273,52889
"India","IN",1366417756,2020-08-20,203,69652,977,2836925,53866
"India","IN",1366417756,2020-08-21,204,68898,983,2905823,54849
"India","IN",1366417756,2020-08-22,205,69878,945,2975701,55794
"India","IN",1366417756,2020-08-23,206,69239,912,3044940,56706
"India","IN",1366417756,2020-08-24,207,61408,836,3106348,57542
"India","IN",1366417756,2020-08-25,208,60975,848,3167323,58390
"India","IN",1366417756,2020-08-26,209,67151,1059,3234474,59449
"India","IN",1366417756,2020-08-27,210,75760,1023,3310234,60472
"India","IN",1366417756,2020-08-28,211,77266,1057,3387500,61529
"India","IN",1366417756,2020-08-29,212,76472,1021,3463972,62550
"India","IN",1366417756,2020-08-30,213,78761,948,3542733,63498
"India","IN",1366417756,2020-08-31,214,78512,971,3621245,64469
"India","IN",1366417756,2020-09-01,215,69921,759,3691166,65228
"India","IN",1366417756,2020-09-02,216,78357,1105,3769523,66333
"India","IN",1366417756,2020-09-03,217,83883,1043,3853406,67376
"India","IN",1366417756,2020-09-04,218,83341,1096,3936747,68472
"India","IN",1366417756,2020-09-05,219,86432,1089,4023179,69561
"India","IN",1366417756,2020-09-06,220,90632,1065,4113811,70626
"India","IN",1366417756,2020-09-07,221,90802,1016,4204613,71642
"India","IN",1366417756,2020-09-08,222,75809,1133,4280422,72775
"India","IN",1366417756,2020-09-09,223,89706,1115,4370128,73890
"India","IN",1366417756,2020-09-10,224,95735,1172,4465863,75062
"India","IN",1366417756,2020-09-11,225,96551,1209,4562414,76271
"India","IN",1366417756,2020-09-12,226,97570,1201,4659984,77472
"India","IN",1366417756,2020-09-13,227,94372,1114,4754356,78586
"India","IN",1366417756,2020-09-14,228,92071,1136,4846427,79722
"India","IN",1366417756,2020-09-15,229,83809,1054,4930236,80776
"India","IN",1366417756,2020-09-16,230,90123,1290,5020359,82066
"India","IN",1366417756,2020-09-17,231,97894,1132,5118253,83198
"India","IN",1366417756,2020-09-18,232,96424,1174,5214677,84372
"India","IN",1366417756,2020-09-19,233,93337,1247,5308014,85619
"India","IN",1366417756,2020-09-20,234,92605,1133,5400619,86752
"India","IN",1366417756,2020-09-21,235,86961,1130,5487580,87882
"India","IN",1366417756,2020-09-22,236,75083,1053,5562663,88935
"India","IN",1366417756,2020-09-23,237,83347,1085,5646010,90020
"India","IN",1366417756,2020-09-24,238,86508,1129,5732518,91149
"India","IN",1366417756,2020-09-25,239,86052,1141,5818570,92290
"India","IN",1366417756,2020-09-26,240,85362,1089,5903932,93379
"India","IN",1366417756,2020-09-27,241,88600,1124,5992532,94503
"India","IN",1366417756,2020-09-28,242,82170,1039,6074702,95542
"India","IN",1366417756,2020-09-29,243,70589,776,6145291,96318
"India","IN",1366417756,2020-09-30,244,80472,1179,6225763,97497
"India","IN",1366417756,2020-10-01,245,86821,1181,6312584,98678
"India","IN",1366417756,2020-10-02,246,81484,1095,6394068,99773
"India","IN",1366417756,2020-10-03,247,79476,1069,6473544,100842
"India","IN",1366417756,2020-10-04,248,75829,940,6549373,101782
"India","IN",1366417756,2020-10-05,249,74442,903,6623815,102685
"India","IN",1366417756,2020-10-06,250,61267,884,6685082,103569
"India","IN",1366417756,2020-10-07,251,72049,986,6757131,104555
"India","IN",1366417756,2020-10-08,252,78524,971,6835655,105526
"India","IN",1366417756,2020-10-09,253,70496,964,6906151,106490
"India","IN",1366417756,2020-10-10,254,73272,926,6979423,107416
"India","IN",1366417756,2020-10-11,255,74383,918,7053806,108334
"India","IN",1366417756,2020-10-12,256,66732,816,7120538,109150
"India","IN",1366417756,2020-10-13,257,55342,706,7175880,109856
"India","IN",1366417756,2020-10-14,258,63509,730,7239389,110586
"India","IN",1366417756,2020-10-15,259,67708,680,7307097,111266
"India","IN",1366417756,2020-10-16,260,63371,895,7370468,112161
"India","IN",1366417756,2020-10-17,261,62212,837,7432680,112998
"India","IN",1366417756,2020-10-18,262,61871,1033,7494551,114031
"India","IN",1366417756,2020-10-19,263,55722,579,7550273,114610
"India","IN",1366417756,2020-10-20,264,46790,587,7597063,115197
"India","IN",1366417756,2020-10-21,265,54044,717,7651107,115914
"India","IN",1366417756,2020-10-22,266,55839,702,7706946,116616
"India","IN",1366417756,2020-10-23,267,54366,690,7761312,117306
"India","IN",1366417756,2020-10-24,268,53370,650,7814682,117956
"India","IN",1366417756,2020-10-25,269,50129,578,7864811,118534
"India","IN",1366417756,2020-10-26,270,45148,480,7909959,119014
"India","IN",1366417756,2020-10-27,271,36470,488,7946429,119502
"India","IN",1366417756,2020-10-28,272,43893,508,7990322,120010
"India","IN",1366417756,2020-10-29,273,49881,517,8040203,120527
"India","IN",1366417756,2020-10-30,274,48648,563,8088851,121090
"India","IN",1366417756,2020-10-31,275,48268,551,8137119,121641
"India","IN",1366417756,2020-11-01,276,46963,470,8184082,122111
"India","IN",1366417756,2020-11-02,277,45231,496,8229313,122607
"India","IN",1366417756,2020-11-03,278,38310,490,8267623,123097
"India","IN",1366417756,2020-11-04,279,46253,514,8313876,123611
"India","IN",1366417756,2020-11-05,280,50210,704,8364086,124315
"India","IN",1366417756,2020-11-06,281,47638,670,8411724,124985
"India","IN",1366417756,2020-11-07,282,50356,577,8462080,125562
"India","IN",1366417756,2020-11-08,283,45674,559,8507754,126121
"India","IN",1366417756,2020-11-09,284,45903,490,8553657,126611
"India","IN",1366417756,2020-11-10,285,38073,448,8591730,127059
"India","IN",1366417756,2020-11-11,286,44281,512,8636011,127571
"India","IN",1366417756,2020-11-12,287,47905,550,8683916,128121
"India","IN",1366417756,2020-11-13,288,44879,547,8728795,128668
"India","IN",1366417756,2020-11-14,289,44684,520,8773479,129188
"India","IN",1366417756,2020-11-15,290,41100,447,8814579,129635
"India","IN",1366417756,2020-11-16,291,30548,435,8845127,130070
"India","IN",1366417756,2020-11-17,292,29163,449,8874290,130519
"India","IN",1366417756,2020-11-18,293,38617,474,8912907,130993
"India","IN",1366417756,2020-11-19,294,45576,585,8958483,131578
"India","IN",1366417756,2020-11-20,295,45882,584,9004365,132162
"India","IN",1366417756,2020-11-21,296,46232,564,9050597,132726
"India","IN",1366417756,2020-11-22,297,45209,501,9095806,133227
"India","IN",1366417756,2020-11-23,298,44059,511,9139865,133738
"India","IN",1366417756,2020-11-24,299,37975,480,9177840,134218
"India","IN",1366417756,2020-11-25,300,44376,481,9222216,134699
"India","IN",1366417756,2020-11-26,301,44489,524,9266705,135223
"India","IN",1366417756,2020-11-27,302,43082,492,9309787,135715
"India","IN",1366417756,2020-11-28,303,41322,485,9351109,136200
"India","IN",1366417756,2020-11-29,304,41810,496,9392919,136696
"India","IN",1366417756,2020-11-30,305,38772,443,9431691,137139
"India","IN",1366417756,2020-12-01,306,31118,482,9462809,137621
"India","IN",1366417756,2020-12-02,307,36604,501,9499413,138122
"India","IN",1366417756,2020-12-03,308,35551,526,9534964,138648
"India","IN",1366417756,2020-12-04,309,36595,540,9571559,139188
"India","IN",1366417756,2020-12-05,310,36652,512,9608211,139700
"India","IN",1366417756,2020-12-06,311,36011,482,9644222,140182
"India","IN",1366417756,2020-12-07,312,32981,391,9677203,140573
"India","IN",1366417756,2020-12-08,313,26567,385,9703770,140958
"India","IN",1366417756,2020-12-09,314,32080,402,9735850,141360
"India","IN",1366417756,2020-12-10,315,31521,412,9767371,141772
"India","IN",1366417756,2020-12-11,316,29398,414,9796769,142186
"India","IN",1366417756,2020-12-12,317,30006,442,9826775,142628
"India","IN",1366417756,2020-12-13,318,30254,391,9857029,143019
"India","IN",1366417756,2020-12-14,319,27071,336,9884100,143355
"Russia","RU",145872260,2020-02-01,1,2,0,2,0
"Russia","RU",145872260,2020-02-02,2,0,0,2,0
"Russia","RU",145872260,2020-02-03,3,0,0,2,0
"Russia","RU",145872260,2020-02-04,4,0,0,2,0
"Russia","RU",145872260,2020-02-05,5,0,0,2,0
"Russia","RU",145872260,2020-02-06,6,0,0,2,0
"Russia","RU",145872260,2020-02-07,7,0,0,2,0
"Russia","RU",145872260,2020-02-08,8,0,0,2,0
"Russia","RU",145872260,2020-02-09,9,0,0,2,0
"Russia","RU",145872260,2020-02-10,10,0,0,2,0
"Russia","RU",145872260,2020-02-11,11,0,0,2,0
"Russia","RU",145872260,2020-02-12,12,0,0,2,0
"Russia","RU",145872260,2020-02-13,13,0,0,2,0
"Russia","RU",145872260,2020-02-14,14,0,0,2,0
"Russia","RU",145872260,2020-02-15,15,0,0,2,0
"Russia","RU",145872260,2020-02-16,16,0,0,2,0
"Russia","RU",145872260,2020-02-17,17,0,0,2,0
"Russia","RU",145872260,2020-02-18,18,0,0,2,0
"Russia","RU",145872260,2020-02-19,19,0,0,2,0
"Russia","RU",145872260,2020-02-20,20,0,0,2,0
"Russia","RU",145872260,2020-02-21,21,0,0,2,0
"Russia","RU",145872260,2020-02-22,22,0,0,2,0
"Russia","RU",145872260,2020-02-23,23,0,0,2,0
"Russia","RU",145872260,2020-02-24,24,0,0,2,0
"Russia","RU",145872260,2020-02-25,25,0,0,2,0
"Russia","RU",145872260,2020-02-26,26,0,0,2,0
"Russia","RU",145872260,2020-02-27,27,0,0,2,0
"Russia","RU",145872260,2020-02-28,28,0,0,2,0
"Russia","RU",145872260,2020-02-29,29,0,0,2,0
"Russia","RU",145872260,2020-03-01,30,0,0,2,0
"Russia","RU",145872260,2020-03-02,31,0,0,2,0
"Russia","RU",145872260,2020-03-03,32,1,0,3,0
"Russia","RU",145872260,2020-03-04,33,1,0,4,0
"Russia","RU",145872260,2020-03-05,34,0,0,4,0
"Russia","RU",145872260,2020-03-06,35,0,0,4,0
"Russia","RU",145872260,2020-03-07,36,6,0,10,0
"Russia","RU",145872260,2020-03-08,37,0,0,10,0
"Russia","RU",145872260,2020-03-09,38,0,0,10,0
"Russia","RU",145872260,2020-03-10,39,0,0,10,0
"Russia","RU",145872260,2020-03-11,40,0,0,10,0
"Russia","RU",145872260,2020-03-12,41,15,0,25,0
"Russia","RU",145872260,2020-03-13,42,5,0,30,0
"Russia","RU",145872260,2020-03-14,43,15,0,45,0
"Russia","RU",145872260,2020-03-15,44,14,0,59,0
"Russia","RU",145872260,2020-03-16,45,4,0,63,0
"Russia","RU",145872260,2020-03-17,46,30,0,93,0
"Russia","RU",145872260,2020-03-18,47,21,0,114,0
"Russia","RU",145872260,2020-03-19,48,33,0,147,0
"Russia","RU",145872260,2020-03-20,49,52,0,199,0
"Russia","RU",145872260,2020-03-21,50,54,0,253,0
"Russia","RU",145872260,2020-03-22,51,53,0,306,0
"Russia","RU",145872260,2020-03-23,52,61,0,367,0
"Russia","RU",145872260,2020-03-24,53,71,0,438,0
"Russia","RU",145872260,2020-03-25,54,57,0,495,0
"Russia","RU",145872260,2020-03-26,55,163,0,658,0
"Russia","RU",145872260,2020-03-27,56,182,2,840,2
"Russia","RU",145872260,2020-03-28,57,196,2,1036,4
"Russia","RU",145872260,2020-03-29,58,228,1,1264,5
"Russia","RU",145872260,2020-03-30,59,270,3,1534,8
"Russia","RU",145872260,2020-03-31,60,302,2,1836,10
"Russia","RU",145872260,2020-04-01,61,501,7,2337,17
"Russia","RU",145872260,2020-04-02,62,440,7,2777,24
"Russia","RU",145872260,2020-04-03,63,771,6,3548,30
"Russia","RU",145872260,2020-04-04,64,601,4,4149,34
"Russia","RU",145872260,2020-04-05,65,582,9,4731,43
"Russia","RU",145872260,2020-04-06,66,658,2,5389,45
"Russia","RU",145872260,2020-04-07,67,954,2,6343,47
"Russia","RU",145872260,2020-04-08,68,1154,11,7497,58
"Russia","RU",145872260,2020-04-09,69,1175,5,8672,63
"Russia","RU",145872260,2020-04-10,70,1459,13,10131,76
"Russia","RU",145872260,2020-04-11,71,1786,18,11917,94
"Russia","RU",145872260,2020-04-12,72,1667,12,13584,106
"Russia","RU",145872260,2020-04-13,73,2186,24,15770,130
"Russia","RU",145872260,2020-04-14,74,2558,18,18328,148
"Russia","RU",145872260,2020-04-15,75,2774,22,21102,170
"Russia","RU",145872260,2020-04-16,76,3388,28,24490,198
"Russia","RU",145872260,2020-04-17,77,3448,34,27938,232
"Russia","RU",145872260,2020-04-18,78,4070,41,32008,273
"Russia","RU",145872260,2020-04-19,79,4785,40,36793,313
"Russia","RU",145872260,2020-04-20,80,6060,48,42853,361
"Russia","RU",145872260,2020-04-21,81,4268,44,47121,405
"Russia","RU",145872260,2020-04-22,82,5642,51,52763,456
"Russia","RU",145872260,2020-04-23,83,5236,57,57999,513
"Russia","RU",145872260,2020-04-24,84,4774,42,62773,555
"Russia","RU",145872260,2020-04-25,85,5849,60,68622,615
"Russia","RU",145872260,2020-04-26,86,5966,66,74588,681
"Russia","RU",145872260,2020-04-27,87,6361,66,80949,747
"Russia","RU",145872260,2020-04-28,88,6198,48,87147,795
"Russia","RU",145872260,2020-04-29,89,6411,72,93558,867
"Russia","RU",145872260,2020-04-30,90,5841,105,99399,972
"Russia","RU",145872260,2020-05-01,91,7099,101,106498,1073
"Russia","RU",145872260,2020-05-02,92,7933,96,114431,1169
"Russia","RU",145872260,2020-05-03,93,9623,53,124054,1222
"Russia","RU",145872260,2020-05-04,94,10633,58,134687,1280
"Russia","RU",145872260,2020-05-05,95,10581,76,145268,1356
"Russia","RU",145872260,2020-05-06,96,10102,95,155370,1451
"Russia","RU",145872260,2020-05-07,97,10559,86,165929,1537
"Russia","RU",145872260,2020-05-08,98,11231,88,177160,1625
"Russia","RU",145872260,2020-05-09,99,10699,98,187859,1723
"Russia","RU",145872260,2020-05-10,100,10817,104,198676,1827
"Russia","RU",145872260,2020-05-11,101,11012,88,209688,1915
"Russia","RU",145872260,2020-05-12,102,11656,94,221344,2009
"Russia","RU",145872260,2020-05-13,103,10899,107,232243,2116
"Russia","RU",145872260,2020-05-14,104,10028,96,242271,2212
"Russia","RU",145872260,2020-05-15,105,9974,93,252245,2305
"Russia","RU",145872260,2020-05-16,106,10598,113,262843,2418
"Russia","RU",145872260,2020-05-17,107,9200,119,272043,2537
"Russia","RU",145872260,2020-05-18,108,9709,94,281752,2631
"Russia","RU",145872260,2020-05-19,109,8926,91,290678,2722
"Russia","RU",145872260,2020-05-20,110,9263,115,299941,2837
"Russia","RU",145872260,2020-05-21,111,8764,135,308705,2972
"Russia","RU",145872260,2020-05-22,112,8849,127,317554,3099
"Russia","RU",145872260,2020-05-23,113,8894,150,326448,3249
"Russia","RU",145872260,2020-05-24,114,9434,139,335882,3388
"Russia","RU",145872260,2020-05-25,115,8599,153,344481,3541
"Russia","RU",145872260,2020-05-26,116,8946,92,353427,3633
"Russia","RU",145872260,2020-05-27,117,8915,174,362342,3807
"Russia","RU",145872260,2020-05-28,118,8338,161,370680,3968
"Russia","RU",145872260,2020-05-29,119,8371,174,379051,4142
"Russia","RU",145872260,2020-05-30,120,8572,232,387623,4374
"Russia","RU",145872260,2020-05-31,121,8952,181,396575,4555
"Russia","RU",145872260,2020-06-01,122,9268,138,405843,4693
"Russia","RU",145872260,2020-06-02,123,9035,162,414878,4855
"Russia","RU",145872260,2020-06-03,124,8863,182,423741,5037
"Russia","RU",145872260,2020-06-04,125,8536,178,432277,5215
"Russia","RU",145872260,2020-06-05,126,8831,169,441108,5384
"Russia","RU",145872260,2020-06-06,127,8726,144,449834,5528
"Russia","RU",145872260,2020-06-07,128,8855,197,458689,5725
"Russia","RU",145872260,2020-06-08,129,8984,134,467673,5859
"Russia","RU",145872260,2020-06-09,130,8985,112,476658,5971
"Russia","RU",145872260,2020-06-10,131,8595,170,485253,6141
"Russia","RU",145872260,2020-06-11,132,8404,217,493657,6358
"Russia","RU",145872260,2020-06-12,133,8779,174,502436,6532
"Russia","RU",145872260,2020-06-13,134,8987,183,511423,6715
"Russia","RU",145872260,2020-06-14,135,8706,114,520129,6829
"Russia","RU",145872260,2020-06-15,136,8835,119,528964,6948
"Russia","RU",145872260,2020-06-16,137,8246,143,537210,7091
"Russia","RU",145872260,2020-06-17,138,8248,193,545458,7284
"Russia","RU",145872260,2020-06-18,139,7843,194,553301,7478
"Russia","RU",145872260,2020-06-19,140,7790,312,561091,7790
"Russia","RU",145872260,2020-06-20,141,7972,182,569063,7972
"Russia","RU",145872260,2020-06-21,142,7889,30,576952,8002
"Russia","RU",145872260,2020-06-22,143,7728,109,584680,8111
"Russia","RU",145872260,2020-06-23,144,7600,95,592280,8206
"Russia","RU",145872260,2020-06-24,145,7425,153,599705,8359
"Russia","RU",145872260,2020-06-25,146,7176,154,606881,8513
"Russia","RU",145872260,2020-06-26,147,7113,92,613994,8605
"Russia","RU",145872260,2020-06-27,148,6800,176,620794,8781
"Russia","RU",145872260,2020-06-28,149,6852,188,627646,8969
"Russia","RU",145872260,2020-06-29,150,6791,104,634437,9073
"Russia","RU",145872260,2020-06-30,151,6719,93,641156,9166
"Russia","RU",145872260,2020-07-01,152,6693,154,647849,9320
"Russia","RU",145872260,2020-07-02,153,6556,216,654405,9536
"Russia","RU",145872260,2020-07-03,154,6760,147,661165,9683
"Russia","RU",145872260,2020-07-04,155,6718,176,667883,9859
"Russia","RU",145872260,2020-07-05,156,6632,168,674515,10027
"Russia","RU",145872260,2020-07-06,157,6736,134,681251,10161
"Russia","RU",145872260,2020-07-07,158,6611,135,687862,10296
"Russia","RU",145872260,2020-07-08,159,6368,198,694230,10494
"Russia","RU",145872260,2020-07-09,160,6562,173,700792,10667
"Russia","RU",145872260,2020-07-10,161,6509,176,707301,10843
"Russia","RU",145872260,2020-07-11,162,6635,174,713936,11017
"Russia","RU",145872260,2020-07-12,163,6611,188,720547,11205
"Russia","RU",145872260,2020-07-13,164,6615,130,727162,11335
"Russia","RU",145872260,2020-07-14,165,6537,104,733699,11439
"Russia","RU",145872260,2020-07-15,166,6248,175,739947,11614
"Russia","RU",145872260,2020-07-16,167,6422,156,746369,11770
"Russia","RU",145872260,2020-07-17,168,6428,167,752797,11937
"Russia","RU",145872260,2020-07-18,169,6406,186,759203,12123
"Russia","RU",145872260,2020-07-19,170,6234,124,765437,12247
"Russia","RU",145872260,2020-07-20,171,6109,95,771546,12342
"Russia","RU",145872260,2020-07-21,172,5940,85,777486,12427
"Russia","RU",145872260,2020-07-22,173,5842,153,783328,12580
"Russia","RU",145872260,2020-07-23,174,5862,165,789190,12745
"Russia","RU",145872260,2020-07-24,175,5848,147,795038,12892
"Russia","RU",145872260,2020-07-25,176,5811,154,800849,13046
"Russia","RU",145872260,2020-07-26,177,5871,146,806720,13192
"Russia","RU",145872260,2020-07-27,178,5765,77,812485,13269
"Russia","RU",145872260,2020-07-28,179,5635,85,818120,13354
"Russia","RU",145872260,2020-07-29,180,5395,150,823515,13504
"Russia","RU",145872260,2020-07-30,181,5475,169,828990,13673
"Russia","RU",145872260,2020-07-31,182,5509,129,834499,13802
"Russia","RU",145872260,2020-08-01,183,5482,161,839981,13963
"Russia","RU",145872260,2020-08-02,184,5462,95,845443,14058
"Russia","RU",145872260,2020-08-03,185,5427,70,850870,14128
"Russia","RU",145872260,2020-08-04,186,5394,79,856264,14207
"Russia","RU",145872260,2020-08-05,187,5159,144,861423,14351
"Russia","RU",145872260,2020-08-06,188,5920,181,867343,14532
"Russia","RU",145872260,2020-08-07,189,4551,74,871894,14606
"Russia","RU",145872260,2020-08-08,190,5241,119,877135,14725
"Russia","RU",145872260,2020-08-09,191,5212,129,882347,14854
"Russia","RU",145872260,2020-08-10,192,5189,77,887536,14931
"Russia","RU",145872260,2020-08-11,193,5118,130,892654,15061
"Russia","RU",145872260,2020-08-12,194,4945,70,897599,15131
"Russia","RU",145872260,2020-08-13,195,5102,129,902701,15260
"Russia","RU",145872260,2020-08-14,196,5057,124,907758,15384
"Russia","RU",145872260,2020-08-15,197,5065,114,912823,15498
"Russia","RU",145872260,2020-08-16,198,5061,119,917884,15617
"Russia","RU",145872260,2020-08-17,199,4969,68,922853,15685
"Russia","RU",145872260,2020-08-18,200,4892,55,927745,15740
"Russia","RU",145872260,2020-08-19,201,4748,132,932493,15872
"Russia","RU",145872260,2020-08-20,202,4828,117,937321,15989
"Russia","RU",145872260,2020-08-21,203,4785,110,942106,16099
"Russia","RU",145872260,2020-08-22,204,4870,90,946976,16189
"Russia","RU",145872260,2020-08-23,205,4921,121,951897,16310
"Russia","RU",145872260,2020-08-24,206,4852,73,956749,16383
"Russia","RU",145872260,2020-08-25,207,4744,65,961493,16448
"Russia","RU",145872260,2020-08-26,208,4696,120,966189,16568
"Russia","RU",145872260,2020-08-27,209,4676,115,970865,16683
"Russia","RU",145872260,2020-08-28,210,4711,121,975576,16804
"Russia","RU",145872260,2020-08-29,211,4829,110,980405,16914
"Russia","RU",145872260,2020-08-30,212,4941,111,985346,17025
"Russia","RU",145872260,2020-08-31,213,4980,68,990326,17093
"Russia","RU",145872260,2020-09-01,214,4993,83,995319,17176
"Russia","RU",145872260,2020-09-02,215,4729,123,1000048,17299
"Russia","RU",145872260,2020-09-03,216,4952,115,1005000,17414
"Russia","RU",145872260,2020-09-04,217,4995,114,1009995,17528
"Russia","RU",145872260,2020-09-05,218,5110,121,1015105,17649
"Russia","RU",145872260,2020-09-06,219,5205,110,1020310,17759
"Russia","RU",145872260,2020-09-07,220,5195,61,1025505,17820
"Russia","RU",145872260,2020-09-08,221,5185,51,1030690,17871
"Russia","RU",145872260,2020-09-09,222,5099,122,1035789,17993
"Russia","RU",145872260,2020-09-10,223,5218,160,1041007,18153
"Russia","RU",145872260,2020-09-11,224,5363,110,1046370,18263
"Russia","RU",145872260,2020-09-12,225,5504,102,1051874,18365
"Russia","RU",145872260,2020-09-13,226,5488,119,1057362,18484
"Russia","RU",145872260,2020-09-14,227,5449,94,1062811,18578
"Russia","RU",145872260,2020-09-15,228,5509,57,1068320,18635
"Russia","RU",145872260,2020-09-16,229,5529,150,1073849,18785
"Russia","RU",145872260,2020-09-17,230,5670,132,1079519,18917
"Russia","RU",145872260,2020-09-18,231,5762,144,1085281,19061
"Russia","RU",145872260,2020-09-19,232,5905,134,1091186,19195
"Russia","RU",145872260,2020-09-20,233,6065,144,1097251,19339
"Russia","RU",145872260,2020-09-21,234,6148,79,1103399,19418
"Russia","RU",145872260,2020-09-22,235,6196,71,1109595,19489
"Russia","RU",145872260,2020-09-23,236,6215,160,1115810,19649
"Russia","RU",145872260,2020-09-24,237,6431,150,1122241,19799
"Russia","RU",145872260,2020-09-25,238,6595,149,1128836,19948
"Russia","RU",145872260,2020-09-26,239,7212,108,1136048,20056
"Russia","RU",145872260,2020-09-27,240,7523,169,1143571,20225
"Russia","RU",145872260,2020-09-28,241,7867,99,1151438,20324
"Russia","RU",145872260,2020-09-29,242,8135,61,1159573,20385
"Russia","RU",145872260,2020-09-30,243,8232,160,1167805,20545
"Russia","RU",145872260,2020-10-01,244,8481,177,1176286,20722
"Russia","RU",145872260,2020-10-02,245,8945,169,1185231,20891
"Russia","RU",145872260,2020-10-03,246,9412,186,1194643,21077
"Russia","RU",145872260,2020-10-04,247,9859,174,1204502,21251
"Russia","RU",145872260,2020-10-05,248,10499,107,1215001,21358
"Russia","RU",145872260,2020-10-06,249,10888,117,1225889,21475
"Russia","RU",145872260,2020-10-07,250,11615,188,1237504,21663
"Russia","RU",145872260,2020-10-08,251,11115,202,1248619,21865
"Russia","RU",145872260,2020-10-09,252,11493,191,1260112,22056
"Russia","RU",145872260,2020-10-10,253,12126,201,1272238,22257
"Russia","RU",145872260,2020-10-11,254,12846,197,1285084,22454
"Russia","RU",145872260,2020-10-12,255,13634,143,1298718,22597
"Russia","RU",145872260,2020-10-13,256,13592,125,1312310,22722
"Russia","RU",145872260,2020-10-14,257,13868,244,1326178,22966
"Russia","RU",145872260,2020-10-15,258,14231,239,1340409,23205
"Russia","RU",145872260,2020-10-16,259,13754,286,1354163,23491
"Russia","RU",145872260,2020-10-17,260,15150,232,1369313,23723
"Russia","RU",145872260,2020-10-18,261,14922,279,1384235,24002
"Russia","RU",145872260,2020-10-19,262,15099,185,1399334,24187
"Russia","RU",145872260,2020-10-20,263,15982,179,1415316,24366
"Russia","RU",145872260,2020-10-21,264,16319,269,1431635,24635
"Russia","RU",145872260,2020-10-22,265,15700,317,1447335,24952
"Russia","RU",145872260,2020-10-23,266,15971,290,1463306,25242
"Russia","RU",145872260,2020-10-24,267,17340,283,1480646,25525
"Russia","RU",145872260,2020-10-25,268,16521,296,1497167,25821
"Russia","RU",145872260,2020-10-26,269,16710,229,1513877,26050
"Russia","RU",145872260,2020-10-27,270,17347,219,1531224,26269
"Russia","RU",145872260,2020-10-28,271,16550,320,1547774,26589
"Russia","RU",145872260,2020-10-29,272,16202,346,1563976,26935
"Russia","RU",145872260,2020-10-30,273,17717,366,1581693,27301
"Russia","RU",145872260,2020-10-31,274,18283,355,1599976,27656
"Russia","RU",145872260,2020-11-01,275,18140,334,1618116,27990
"Russia","RU",145872260,2020-11-02,276,18665,245,1636781,28235
"Russia","RU",145872260,2020-11-03,277,18257,238,1655038,28473
"Russia","RU",145872260,2020-11-04,278,18648,355,1673686,28828
"Russia","RU",145872260,2020-11-05,279,19768,389,1693454,29217
"Russia","RU",145872260,2020-11-06,280,19404,292,1712858,29509
"Russia","RU",145872260,2020-11-07,281,20582,378,1733440,29887
"Russia","RU",145872260,2020-11-08,282,20396,364,1753836,30251
"Russia","RU",145872260,2020-11-09,283,20498,286,1774334,30537
"Russia","RU",145872260,2020-11-10,284,21798,256,1796132,30793
"Russia","RU",145872260,2020-11-11,285,20977,368,1817109,31161
"Russia","RU",145872260,2020-11-12,286,19851,432,1836960,31593
"Russia","RU",145872260,2020-11-13,287,21608,439,1858568,32032
"Russia","RU",145872260,2020-11-14,288,21983,411,1880551,32443
"Russia","RU",145872260,2020-11-15,289,22702,391,1903253,32834
"Russia","RU",145872260,2020-11-16,290,22572,352,1925825,33186
"Russia","RU",145872260,2020-11-17,291,22778,303,1948603,33489
"Russia","RU",145872260,2020-11-18,292,22410,442,1971013,33931
"Russia","RU",145872260,2020-11-19,293,20985,456,1991998,34387
"Russia","RU",145872260,2020-11-20,294,23610,463,2015608,34850
"Russia","RU",145872260,2020-11-21,295,24318,461,2039926,35311
"Russia","RU",145872260,2020-11-22,296,24822,467,2064748,35778
"Russia","RU",145872260,2020-11-23,297,24581,401,2089329,36179
"Russia","RU",145872260,2020-11-24,298,25173,361,2114502,36540
"Russia","RU",145872260,2020-11-25,299,24326,491,2138828,37031
"Russia","RU",145872260,2020-11-26,300,23675,507,2162503,37538
"Russia","RU",145872260,2020-11-27,301,25487,524,2187990,38062
"Russia","RU",145872260,2020-11-28,302,27543,496,2215533,38558
"Russia","RU",145872260,2020-11-29,303,27100,510,2242633,39068
"Russia","RU",145872260,2020-11-30,304,26683,459,2269316,39527
"Russia","RU",145872260,2020-12-01,305,26338,368,2295654,39895
"Russia","RU",145872260,2020-12-02,306,26402,569,2322056,40464
"Russia","RU",145872260,2020-12-03,307,25345,589,2347401,41053
"Russia","RU",145872260,2020-12-04,308,28145,554,2375546,41607
"Russia","RU",145872260,2020-12-05,309,27403,569,2402949,42176
"Russia","RU",145872260,2020-12-06,310,28782,508,2431731,42684
"Russia","RU",145872260,2020-12-07,311,29039,457,2460770,43141
"Russia","RU",145872260,2020-12-08,312,28142,456,2488912,43597
"Russia","RU",145872260,2020-12-09,313,26097,562,2515009,44159
"Russia","RU",145872260,2020-12-10,314,26190,559,2541199,44718
"Russia","RU",145872260,2020-12-11,315,27927,562,2569126,45280
"Russia","RU",145872260,2020-12-12,316,28585,613,2597711,45893
"Russia","RU",145872260,2020-12-13,317,28137,560,2625848,46453
"Russia","RU",145872260,2020-12-14,318,28080,488,2653928,46941
"United_States_of_America","US",329064917,2020-01-21,1,1,0,1,0
"United_States_of_America","US",329064917,2020-01-22,2,0,0,1,0
"United_States_of_America","US",329064917,2020-01-23,3,0,0,1,0
"United_States_of_America","US",329064917,2020-01-24,4,0,0,1,0
"United_States_of_America","US",329064917,2020-01-25,5,1,0,2,0
"United_States_of_America","US",329064917,2020-01-26,6,0,0,2,0
"United_States_of_America","US",329064917,2020-01-27,7,3,0,5,0
"United_States_of_America","US",329064917,2020-01-28,8,0,0,5,0
"United_States_of_America","US",329064917,2020-01-29,9,0,0,5,0
"United_States_of_America","US",329064917,2020-01-30,10,0,0,5,0
"United_States_of_America","US",329064917,2020-01-31,11,1,0,6,0
"United_States_of_America","US",329064917,2020-02-01,12,1,0,7,0
"United_States_of_America","US",329064917,2020-02-02,13,1,0,8,0
"United_States_of_America","US",329064917,2020-02-03,14,3,0,11,0
"United_States_of_America","US",329064917,2020-02-04,15,0,0,11,0
"United_States_of_America","US",329064917,2020-02-05,16,0,0,11,0
"United_States_of_America","US",329064917,2020-02-06,17,1,0,12,0
"United_States_of_America","US",329064917,2020-02-07,18,0,0,12,0
"United_States_of_America","US",329064917,2020-02-08,19,0,0,12,0
"United_States_of_America","US",329064917,2020-02-09,20,0,0,12,0
"United_States_of_America","US",329064917,2020-02-10,21,0,0,12,0
"United_States_of_America","US",329064917,2020-02-11,22,1,0,13,0
"United_States_of_America","US",329064917,2020-02-12,23,0,0,13,0
"United_States_of_America","US",329064917,2020-02-13,24,1,0,14,0
"United_States_of_America","US",329064917,2020-02-14,25,1,0,15,0
"United_States_of_America","US",329064917,2020-02-15,26,0,0,15,0
"United_States_of_America","US",329064917,2020-02-16,27,0,0,15,0
"United_States_of_America","US",329064917,2020-02-17,28,0,0,15,0
"United_States_of_America","US",329064917,2020-02-18,29,0,0,15,0
"United_States_of_America","US",329064917,2020-02-19,30,0,0,15,0
"United_States_of_America","US",329064917,2020-02-20,31,0,0,15,0
"United_States_of_America","US",329064917,2020-02-21,32,1,0,16,0
"United_States_of_America","US",329064917,2020-02-22,33,19,0,35,0
"United_States_of_America","US",329064917,2020-02-23,34,0,0,35,0
"United_States_of_America","US",329064917,2020-02-24,35,0,0,35,0
"United_States_of_America","US",329064917,2020-02-25,36,18,0,53,0
"United_States_of_America","US",329064917,2020-02-26,37,0,0,53,0
"United_States_of_America","US",329064917,2020-02-27,38,6,0,59,0
"United_States_of_America","US",329064917,2020-02-28,39,1,0,60,0
"United_States_of_America","US",329064917,2020-02-29,40,6,0,66,0
"United_States_of_America","US",329064917,2020-03-01,41,3,1,69,1
"United_States_of_America","US",329064917,2020-03-02,42,20,1,89,2
"United_States_of_America","US",329064917,2020-03-03,43,14,4,103,6
"United_States_of_America","US",329064917,2020-03-04,44,22,3,125,9
"United_States_of_America","US",329064917,2020-03-05,45,34,2,159,11
"United_States_of_America","US",329064917,2020-03-06,46,74,1,233,12
"United_States_of_America","US",329064917,2020-03-07,47,105,2,338,14
"United_States_of_America","US",329064917,2020-03-08,48,95,3,433,17
"United_States_of_America","US",329064917,2020-03-09,49,121,4,554,21
"United_States_of_America","US",329064917,2020-03-10,50,200,5,754,26
"United_States_of_America","US",329064917,2020-03-11,51,271,2,1025,28
"United_States_of_America","US",329064917,2020-03-12,52,287,2,1312,30
"United_States_of_America","US",329064917,2020-03-13,53,351,10,1663,40
"United_States_of_America","US",329064917,2020-03-14,54,511,7,2174,47
"United_States_of_America","US",329064917,2020-03-15,55,777,10,2951,57
"United_States_of_America","US",329064917,2020-03-16,56,823,12,3774,69
"United_States_of_America","US",329064917,2020-03-17,57,887,16,4661,85
"United_States_of_America","US",329064917,2020-03-18,58,1766,23,6427,108
"United_States_of_America","US",329064917,2020-03-19,59,2988,42,9415,150
"United_States_of_America","US",329064917,2020-03-20,60,4835,0,14250,150
"United_States_of_America","US",329064917,2020-03-21,61,5374,110,19624,260
"United_States_of_America","US",329064917,2020-03-22,62,7123,80,26747,340
"United_States_of_America","US",329064917,2020-03-23,63,8459,131,35206,471
"United_States_of_America","US",329064917,2020-03-24,64,11236,119,46442,590
"United_States_of_America","US",329064917,2020-03-25,65,8789,211,55231,801
"United_States_of_America","US",329064917,2020-03-26,66,13963,249,69194,1050
"United_States_of_America","US",329064917,2020-03-27,67,16797,246,85991,1296
"United_States_of_America","US",329064917,2020-03-28,68,18695,411,104686,1707
"United_States_of_America","US",329064917,2020-03-29,69,19979,484,124665,2191
"United_States_of_America","US",329064917,2020-03-30,70,18360,318,143025,2509
"United_States_of_America","US",329064917,2020-03-31,71,21595,661,164620,3170
"United_States_of_America","US",329064917,2020-04-01,72,24998,909,189618,4079
"United_States_of_America","US",329064917,2020-04-02,73,27103,1059,216721,5138
"United_States_of_America","US",329064917,2020-04-03,74,28819,915,245540,6053
"United_States_of_America","US",329064917,2020-04-04,75,32425,1104,277965,7157
"United_States_of_America","US",329064917,2020-04-05,76,34272,1344,312237,8501
"United_States_of_America","US",329064917,2020-04-06,77,25398,1146,337635,9647
"United_States_of_America","US",329064917,2020-04-07,78,30561,1342,368196,10989
"United_States_of_America","US",329064917,2020-04-08,79,30613,1906,398809,12895
"United_States_of_America","US",329064917,2020-04-09,80,33323,1922,432132,14817
"United_States_of_America","US",329064917,2020-04-10,81,33901,1873,466033,16690
"United_States_of_America","US",329064917,2020-04-11,82,35527,2087,501560,18777
"United_States_of_America","US",329064917,2020-04-12,83,28391,1831,529951,20608
"United_States_of_America","US",329064917,2020-04-13,84,27620,1500,557571,22108
"United_States_of_America","US",329064917,2020-04-14,85,25023,1541,582594,23649
"United_States_of_America","US",329064917,2020-04-15,86,26922,2408,609516,26057
"United_States_of_America","US",329064917,2020-04-16,87,30148,4928,639664,30985
"United_States_of_America","US",329064917,2020-04-17,88,31667,2299,671331,33284
"United_States_of_America","US",329064917,2020-04-18,89,30833,3770,702164,37054
"United_States_of_America","US",329064917,2020-04-19,90,32922,1856,735086,38910
"United_States_of_America","US",329064917,2020-04-20,91,24601,1772,759687,40682
"United_States_of_America","US",329064917,2020-04-21,92,28065,1857,787752,42539
"United_States_of_America","US",329064917,2020-04-22,93,37289,2524,825041,45063
"United_States_of_America","US",329064917,2020-04-23,94,17588,1721,842629,46784
"United_States_of_America","US",329064917,2020-04-24,95,26543,3179,869172,49963
"United_States_of_America","US",329064917,2020-04-25,96,21352,1054,890524,51017
"United_States_of_America","US",329064917,2020-04-26,97,48529,2172,939053,53189
"United_States_of_America","US",329064917,2020-04-27,98,26857,1687,965910,54876
"United_States_of_America","US",329064917,2020-04-28,99,22541,1369,988451,56245
"United_States_of_America","US",329064917,2020-04-29,100,24132,2110,1012583,58355
"United_States_of_America","US",329064917,2020-04-30,101,27326,2611,1039909,60966
"United_States_of_America","US",329064917,2020-05-01,102,29917,2040,1069826,63006
"United_States_of_America","US",329064917,2020-05-02,103,33955,2062,1103781,65068
"United_States_of_America","US",329064917,2020-05-03,104,29288,1317,1133069,66385
"United_States_of_America","US",329064917,2020-05-04,105,24972,1297,1158041,67682
"United_States_of_America","US",329064917,2020-05-05,106,22593,1252,1180634,68934
"United_States_of_America","US",329064917,2020-05-06,107,23841,2144,1204475,71078
"United_States_of_America","US",329064917,2020-05-07,108,24128,2353,1228603,73431
"United_States_of_America","US",329064917,2020-05-08,109,28369,2239,1256972,75670
"United_States_of_America","US",329064917,2020-05-09,110,26957,1510,1283929,77180
"United_States_of_America","US",329064917,2020-05-10,111,25612,1614,1309541,78794
"United_States_of_America","US",329064917,2020-05-11,112,20258,734,1329799,79528
"United_States_of_America","US",329064917,2020-05-12,113,18117,1156,1347916,80684
"United_States_of_America","US",329064917,2020-05-13,114,22048,1703,1369964,82387
"United_States_of_America","US",329064917,2020-05-14,115,20782,1746,1390746,84133
"United_States_of_America","US",329064917,2020-05-15,116,27143,1773,1417889,85906
"United_States_of_America","US",329064917,2020-05-16,117,25508,1662,1443397,87568
"United_States_of_America","US",329064917,2020-05-17,118,24487,1186,1467884,88754
"United_States_of_America","US",329064917,2020-05-18,119,18873,808,1486757,89562
"United_States_of_America","US",329064917,2020-05-19,120,21841,791,1508598,90353
"United_States_of_America","US",329064917,2020-05-20,121,19970,1568,1528568,91921
"United_States_of_America","US",329064917,2020-05-21,122,23285,1518,1551853,93439
"United_States_of_America","US",329064917,2020-05-22,123,25434,1263,1577287,94702
"United_States_of_America","US",329064917,2020-05-23,124,24147,1305,1601434,96007
"United_States_of_America","US",329064917,2020-05-24,125,21236,1080,1622670,97087
"United_States_of_America","US",329064917,2020-05-25,126,20568,633,1643238,97720
"United_States_of_America","US",329064917,2020-05-26,127,19064,500,1662302,98220
"United_States_of_America","US",329064917,2020-05-27,128,18910,696,1681212,98916
"United_States_of_America","US",329064917,2020-05-28,129,18721,1526,1699933,100442
"United_States_of_America","US",329064917,2020-05-29,130,21817,1175,1721750,101617
"United_States_of_America","US",329064917,2020-05-30,131,25337,1219,1747087,102836
"United_States_of_America","US",329064917,2020-05-31,132,23297,945,1770384,103781
"United_States_of_America","US",329064917,2020-06-01,133,19807,602,1790191,104383
"United_States_of_America","US",329064917,2020-06-02,134,21086,764,1811277,105147
"United_States_of_America","US",329064917,2020-06-03,135,20544,1034,1831821,106181
"United_States_of_America","US",329064917,2020-06-04,136,19699,994,1851520,107175
"United_States_of_America","US",329064917,2020-06-05,137,21140,1036,1872660,108211
"United_States_of_America","US",329064917,2020-06-06,138,25178,932,1897838,109143
"United_States_of_America","US",329064917,2020-06-07,139,22223,659,1920061,109802
"United_States_of_America","US",329064917,2020-06-08,140,22302,712,1942363,110514
"United_States_of_America","US",329064917,2020-06-09,141,18822,493,1961185,111007
"United_States_of_America","US",329064917,2020-06-10,142,18665,999,1979850,112006
"United_States_of_America","US",329064917,2020-06-11,143,20614,918,2000464,112924
"United_States_of_America","US",329064917,2020-06-12,144,22883,896,2023347,113820
"United_States_of_America","US",329064917,2020-06-13,145,25639,849,2048986,114669
"United_States_of_America","US",329064917,2020-06-14,146,25540,767,2074526,115436
"United_States_of_America","US",329064917,2020-06-15,147,19543,296,2094069,115732
"United_States_of_America","US",329064917,2020-06-16,148,19957,395,2114026,116127
"United_States_of_America","US",329064917,2020-06-17,149,23705,836,2137731,116963
"United_States_of_America","US",329064917,2020-06-18,150,25559,754,2163290,117717
"United_States_of_America","US",329064917,2020-06-19,151,27762,717,2191052,118434
"United_States_of_America","US",329064917,2020-06-20,152,29909,678,2220961,119112
"United_States_of_America","US",329064917,2020-06-21,153,34158,607,2255119,119719
"United_States_of_America","US",329064917,2020-06-22,154,25793,256,2280912,119975
"United_States_of_America","US",329064917,2020-06-23,155,31390,427,2312302,120402
"United_States_of_America","US",329064917,2020-06-24,156,34720,826,2347022,121228
"United_States_of_America","US",329064917,2020-06-25,157,34339,751,2381361,121979
"United_States_of_America","US",329064917,2020-06-26,158,40949,2437,2422310,124416
"United_States_of_America","US",329064917,2020-06-27,159,45527,623,2467837,125039
"United_States_of_America","US",329064917,2020-06-28,160,42486,500,2510323,125539
"United_States_of_America","US",329064917,2020-06-29,161,38673,265,2548996,125804
"United_States_of_America","US",329064917,2020-06-30,162,41556,336,2590552,126140
"United_States_of_America","US",329064917,2020-07-01,163,43880,1270,2634432,127410
"United_States_of_America","US",329064917,2020-07-02,164,52048,652,2686480,128062
"United_States_of_America","US",329064917,2020-07-03,165,53399,678,2739879,128740
"United_States_of_America","US",329064917,2020-07-04,166,54442,694,2794321,129434
"United_States_of_America","US",329064917,2020-07-05,167,45221,242,2839542,129676
"United_States_of_America","US",329064917,2020-07-06,168,49093,271,2888635,129947
"United_States_of_America","US",329064917,2020-07-07,169,49990,359,2938625,130306
"United_States_of_America","US",329064917,2020-07-08,170,57473,1174,2996098,131480
"United_States_of_America","US",329064917,2020-07-09,171,58906,829,3055004,132309
"United_States_of_America","US",329064917,2020-07-10,172,63004,982,3118008,133291
"United_States_of_America","US",329064917,2020-07-11,173,66625,806,3184633,134097
"United_States_of_America","US",329064917,2020-07-12,174,63051,717,3247684,134814
"United_States_of_America","US",329064917,2020-07-13,175,57258,391,3304942,135205
"United_States_of_America","US",329064917,2020-07-14,176,58114,400,3363056,135605
"United_States_of_America","US",329064917,2020-07-15,177,68518,861,3431574,136466
"United_States_of_America","US",329064917,2020-07-16,178,67717,953,3499291,137419
"United_States_of_America","US",329064917,2020-07-17,179,76930,939,3576221,138358
"United_States_of_America","US",329064917,2020-07-18,180,71494,908,3647715,139266
"United_States_of_America","US",329064917,2020-07-19,181,63749,853,3711464,140119
"United_States_of_America","US",329064917,2020-07-20,182,61796,415,3773260,140534
"United_States_of_America","US",329064917,2020-07-21,183,56750,372,3830010,140906
"United_States_of_America","US",329064917,2020-07-22,184,72048,1160,3902058,142066
"United_States_of_America","US",329064917,2020-07-23,185,68848,1124,3970906,143190
"United_States_of_America","US",329064917,2020-07-24,186,63196,1052,4034102,144242
"United_States_of_America","US",329064917,2020-07-25,187,78427,1304,4112529,145546
"United_States_of_America","US",329064917,2020-07-26,188,65498,914,4178027,146460
"United_States_of_America","US",329064917,2020-07-27,189,55993,475,4234020,146935
"United_States_of_America","US",329064917,2020-07-28,190,56243,1076,4290263,148011
"United_States_of_America","US",329064917,2020-07-29,191,61734,1245,4351997,149256
"United_States_of_America","US",329064917,2020-07-30,192,74985,1457,4426982,150713
"United_States_of_America","US",329064917,2020-07-31,193,68032,1357,4495014,152070
"United_States_of_America","US",329064917,2020-08-01,194,67023,1244,4562037,153314
"United_States_of_America","US",329064917,2020-08-02,195,58407,1133,4620444,154447
"United_States_of_America","US",329064917,2020-08-03,196,47511,413,4667955,154860
"United_States_of_America","US",329064917,2020-08-04,197,45607,543,4713562,155403
"United_States_of_America","US",329064917,2020-08-05,198,57525,1403,4771087,156806
"United_States_of_America","US",329064917,2020-08-06,199,52804,1450,4823891,158256
"United_States_of_America","US",329064917,2020-08-07,200,59755,1848,4883646,160104
"United_States_of_America","US",329064917,2020-08-08,201,58150,1252,4941796,161356
"United_States_of_America","US",329064917,2020-08-09,202,56221,1069,4998017,162425
"United_States_of_America","US",329064917,2020-08-10,203,46847,513,5044864,162938
"United_States_of_America","US",329064917,2020-08-11,204,49530,523,5094394,163461
"United_States_of_America","US",329064917,2020-08-12,205,46813,1076,5141207,164537
"United_States_of_America","US",329064917,2020-08-13,206,55941,1490,5197148,166027
"United_States_of_America","US",329064917,2020-08-14,207,51094,1083,5248242,167110
"United_States_of_America","US",329064917,2020-08-15,208,64838,1336,5313080,168446
"United_States_of_America","US",329064917,2020-08-16,209,48085,1035,5361165,169481
"United_States_of_America","US",329064917,2020-08-17,210,42104,571,5403269,170052
"United_States_of_America","US",329064917,2020-08-18,211,35056,445,5438325,170497
"United_States_of_America","US",329064917,2020-08-19,212,44091,1324,5482416,171821
"United_States_of_America","US",329064917,2020-08-20,213,47426,1356,5529842,173177
"United_States_of_America","US",329064917,2020-08-21,214,44005,1078,5573847,174255
"United_States_of_America","US",329064917,2020-08-22,215,49880,1151,5623727,175406
"United_States_of_America","US",329064917,2020-08-23,216,44378,956,5668105,176362
"United_States_of_America","US",329064917,2020-08-24,217,34506,444,5702611,176806
"United_States_of_America","US",329064917,2020-08-25,218,38298,473,5740909,177279
"United_States_of_America","US",329064917,2020-08-26,219,38119,1207,5779028,178486
"United_States_of_America","US",329064917,2020-08-27,220,42848,1228,5821876,179714
"United_States_of_America","US",329064917,2020-08-28,221,45909,1110,5867785,180824
"United_States_of_America","US",329064917,2020-08-29,222,49654,949,5917439,181773
"United_States_of_America","US",329064917,2020-08-30,223,44143,1006,5961582,182779
"United_States_of_America","US",329064917,2020-08-31,224,35581,290,5997163,183069
"United_States_of_America","US",329064917,2020-09-01,225,33850,529,6031013,183598
"United_States_of_America","US",329064917,2020-09-02,226,44639,1091,6075652,184689
"United_States_of_America","US",329064917,2020-09-03,227,38754,1055,6114406,185744
"United_States_of_America","US",329064917,2020-09-04,228,36249,1053,6150655,186797
"United_States_of_America","US",329064917,2020-09-05,229,51071,968,6201726,187765
"United_States_of_America","US",329064917,2020-09-06,230,44140,773,6245866,188538
"United_States_of_America","US",329064917,2020-09-07,231,30555,403,6276421,188941
"United_States_of_America","US",329064917,2020-09-08,232,24250,267,6300671,189208
"United_States_of_America","US",329064917,2020-09-09,233,27122,471,6327793,189679
"United_States_of_America","US",329064917,2020-09-10,234,31927,1136,6359720,190815
"United_States_of_America","US",329064917,2020-09-11,235,37507,974,6397227,191789
"United_States_of_America","US",329064917,2020-09-12,236,48061,1227,6445288,193016
"United_States_of_America","US",329064917,2020-09-13,237,40820,685,6486108,193701
"United_States_of_America","US",329064917,2020-09-14,238,33871,378,6519979,194079
"United_States_of_America","US",329064917,2020-09-15,239,34841,451,6554820,194530
"United_States_of_America","US",329064917,2020-09-16,240,51473,1407,6606293,195937
"United_States_of_America","US",329064917,2020-09-17,241,24598,865,6630891,196802
"United_States_of_America","US",329064917,2020-09-18,242,43567,831,6674458,197633
"United_States_of_America","US",329064917,2020-09-19,243,50209,956,6724667,198589
"United_States_of_America","US",329064917,2020-09-20,244,40295,669,6764962,199258
"United_States_of_America","US",329064917,2020-09-21,245,39852,251,6804814,199509
"United_States_of_America","US",329064917,2020-09-22,246,53153,372,6857967,199881
"United_States_of_America","US",329064917,2020-09-23,247,38307,926,6896274,200807
"United_States_of_America","US",329064917,2020-09-24,248,37930,1102,6934204,201909
"United_States_of_America","US",329064917,2020-09-25,249,44213,901,6978417,202810
"United_States_of_America","US",329064917,2020-09-26,250,55013,964,7033430,203774
"United_States_of_America","US",329064917,2020-09-27,251,45368,723,7078798,204497
"United_States_of_America","US",329064917,2020-09-28,252,36248,259,7115046,204756
"United_States_of_America","US",329064917,2020-09-29,253,32998,314,7148044,205070
"United_States_of_America","US",329064917,2020-09-30,254,43017,928,7191061,205998
"United_States_of_America","US",329064917,2020-10-01,255,41982,930,7233043,206928
"United_States_of_America","US",329064917,2020-10-02,256,44771,880,7277814,207808
"United_States_of_America","US",329064917,2020-10-03,257,54471,908,7332285,208716
"United_States_of_America","US",329064917,2020-10-04,258,50659,678,7382944,209394
"United_States_of_America","US",329064917,2020-10-05,259,34901,400,7417845,209794
"United_States_of_America","US",329064917,2020-10-06,260,40705,398,7458550,210192
"United_States_of_America","US",329064917,2020-10-07,261,43062,717,7501612,210909
"United_States_of_America","US",329064917,2020-10-08,262,48182,892,7549794,211801
"United_States_of_America","US",329064917,2020-10-09,263,56800,972,7606594,212773
"United_States_of_America","US",329064917,2020-10-10,264,58082,1014,7664676,213787
"United_States_of_America","US",329064917,2020-10-11,265,54271,590,7718947,214377
"United_States_of_America","US",329064917,2020-10-12,266,43597,394,7762544,214771
"United_States_of_America","US",329064917,2020-10-13,267,41653,314,7804197,215085
"United_States_of_America","US",329064917,2020-10-14,268,52517,817,7856714,215902
"United_States_of_America","US",329064917,2020-10-15,269,59386,970,7916100,216872
"United_States_of_America","US",329064917,2020-10-16,270,63785,828,7979885,217700
"United_States_of_America","US",329064917,2020-10-17,271,70256,899,8050141,218599
"United_States_of_America","US",329064917,2020-10-18,272,56611,690,8106752,219289
"United_States_of_America","US",329064917,2020-10-19,273,47843,385,8154595,219674
"United_States_of_America","US",329064917,2020-10-20,274,60160,459,8214755,220133
"United_States_of_America","US",329064917,2020-10-21,275,58549,933,8273304,221066
"United_States_of_America","US",329064917,2020-10-22,276,62978,1135,8336282,222201
"United_States_of_America","US",329064917,2020-10-23,277,72058,841,8408340,223042
"United_States_of_America","US",329064917,2020-10-24,278,85329,953,8493669,223995
"United_States_of_America","US",329064917,2020-10-25,279,83056,904,8576725,224899
"United_States_of_America","US",329064917,2020-10-26,280,59440,331,8636165,225230
"United_States_of_America","US",329064917,2020-10-27,281,68359,505,8704524,225735
"United_States_of_America","US",329064917,2020-10-28,282,75129,988,8779653,226723
"United_States_of_America","US",329064917,2020-10-29,283,78371,977,8858024,227700
"United_States_of_America","US",329064917,2020-10-30,284,88130,968,8946154,228668
"United_States_of_America","US",329064917,2020-10-31,285,101273,1040,9047427,229708
"United_States_of_America","US",329064917,2020-11-01,286,78934,848,9126361,230556
"United_States_of_America","US",329064917,2020-11-02,287,81001,440,9207362,230996
"United_States_of_America","US",329064917,2020-11-03,288,83883,555,9291245,231551
"United_States_of_America","US",329064917,2020-11-04,289,92734,1076,9383979,232627
"United_States_of_America","US",329064917,2020-11-05,290,102507,1102,9486486,233729
"United_States_of_America","US",329064917,2020-11-06,291,122436,1208,9608922,234937
"United_States_of_America","US",329064917,2020-11-07,292,130623,1162,9739545,236099
"United_States_of_America","US",329064917,2020-11-08,293,121413,1014,9860958,237113
"United_States_of_America","US",329064917,2020-11-09,294,110693,459,9971651,237572
"United_States_of_America","US",329064917,2020-11-10,295,138901,679,10110552,238251
"United_States_of_America","US",329064917,2020-11-11,296,147274,1432,10257826,239683
"United_States_of_America","US",329064917,2020-11-12,297,143306,2117,10401132,241800
"United_States_of_America","US",329064917,2020-11-13,298,153669,630,10554801,242430
"United_States_of_America","US",329064917,2020-11-14,299,184813,1915,10739614,244345
"United_States_of_America","US",329064917,2020-11-15,300,165277,1255,10904891,245600
"United_States_of_America","US",329064917,2020-11-16,301,132170,614,11037061,246214
"United_States_of_America","US",329064917,2020-11-17,302,168425,1006,11205486,247220
"United_States_of_America","US",329064917,2020-11-18,303,154316,1467,11359802,248687
"United_States_of_America","US",329064917,2020-11-19,304,170005,1850,11529807,250537
"United_States_of_America","US",329064917,2020-11-20,305,188020,2018,11717827,252555
"United_States_of_America","US",329064917,2020-11-21,306,196117,1858,11913944,254413
"United_States_of_America","US",329064917,2020-11-22,307,175494,1486,12089438,255899
"United_States_of_America","US",329064917,2020-11-23,308,157471,883,12246909,256782
"United_States_of_America","US",329064917,2020-11-24,309,173963,919,12420872,257701
"United_States_of_America","US",329064917,2020-11-25,310,170293,2224,12591165,259925
"United_States_of_America","US",329064917,2020-11-26,311,186589,2341,12777754,262266
"United_States_of_America","US",329064917,2020-11-27,312,106091,1189,12883845,263455
"United_States_of_America","US",329064917,2020-11-28,313,207913,1404,13091758,264859
"United_States_of_America","US",329064917,2020-11-29,314,154893,1204,13246651,266063
"United_States_of_America","US",329064917,2020-11-30,315,136670,810,13383321,266873
"United_States_of_America","US",329064917,2020-12-01,316,157903,1172,13541224,268045
"United_States_of_America","US",329064917,2020-12-02,317,180421,2600,13721645,270645
"United_States_of_America","US",329064917,2020-12-03,318,203311,3190,13924956,273835
"United_States_of_America","US",329064917,2020-12-04,319,214747,2481,14139703,276316
"United_States_of_America","US",329064917,2020-12-05,320,231930,2680,14371633,278996
"United_States_of_America","US",329064917,2020-12-06,321,211933,2203,14583566,281199
"United_States_of_America","US",329064917,2020-12-07,322,173432,1111,14756998,282310
"United_States_of_America","US",329064917,2020-12-08,323,197334,1433,14954332,283743
"United_States_of_America","US",329064917,2020-12-09,324,217344,2564,15171676,286307
"United_States_of_America","US",329064917,2020-12-10,325,220025,3124,15391701,289431
"United_States_of_America","US",329064917,2020-12-11,326,224680,2748,15616381,292179
"United_States_of_America","US",329064917,2020-12-12,327,234633,3343,15851014,295522
"United_States_of_America","US",329064917,2020-12-13,328,216017,2315,16067031,297837
"United_States_of_America","US",329064917,2020-12-14,329,189723,1340,16256754,299177
